ward,geometry,wardName,population,male,female,nppTHPT,nppTertiary,nElderly
An Cựu,"POLYGON ((107.60153198300014 16.456869125000082, 107.60031890900012 16.456912994000106, 107.59654235900013 16.455518724, 107.59410095200019 16.456157684000118, 107.59368896500013 16.453670502000023, 107.59276580700009 16.453149795, 107.5919189450002 16.45008468700007, 107.5904693600001 16.44842147900016, 107.59134674100011 16.446763993000104, 107.59072875900011 16.443559646000097, 107.59240722600003 16.443454743000075, 107.59201049700016 16.440710068000044, 107.59475708100001 16.439842224000017, 107.60135650699999 16.440578461000086, 107.60770416200006 16.440050126000187, 107.60848998900013 16.441343307000125, 107.60588073700006 16.44416046200007, 107.60506439100004 16.44697761600014, 107.60781860300017 16.448776244999976, 107.60214233400012 16.452274322000164, 107.60356140100004 16.45603752100004, 107.60153198300014 16.456869125000082))",Phường An Cựu,24363,12007,12356,518,1037,2436
An Đông,"POLYGON ((107.60781860300017 16.448776244999976, 107.6106033330002 16.446969986000056, 107.61235809300007 16.449707031999992, 107.61339569100011 16.450220107999996, 107.61663818300019 16.44842147900016, 107.61785888600019 16.450405122000063, 107.61773681700015 16.451925278000033, 107.6210479730002 16.45382499700014, 107.61959075900006 16.46147537300004, 107.62395477400008 16.461038590000044, 107.62392425500013 16.45993042100008, 107.62707519500009 16.459693909000066, 107.62649536100008 16.46164512600012, 107.62893676700008 16.46146964999997, 107.62911987300015 16.46237182700014, 107.63055419800008 16.46283149700014, 107.62705230700016 16.46729278600003, 107.62686157200011 16.47023201100012, 107.62384796100002 16.470239639000056, 107.62377929800016 16.47227287400017, 107.61894226100003 16.473211288000186, 107.61586761500001 16.472568513, 107.61487579300001 16.470512391000057, 107.61280059900008 16.471296311000117, 107.6127243050002 16.470386506000068, 107.6118774410001 16.47034645100001, 107.61177825800013 16.466159820000087, 107.61365509100011 16.466186524000022, 107.61363983100006 16.463214875000062, 107.610671997 16.463220596999975, 107.61019134600014 16.4618186940001, 107.60824585000012 16.462465287000043, 107.60698699900013 16.46169471800016, 107.60614013700001 16.46281814600019, 107.60556030200013 16.46263122500011, 107.60263824500004 16.4594593060001, 107.60128784200009 16.459173203000148, 107.60153198300014 16.456869125000082, 107.60356140100004 16.45603752100004, 107.60214233400012 16.452274322000164, 107.60781860300017 16.448776244999976))",Phường An Đông,19105,9353,9752,802,859,2853
An Hòa,"POLYGON ((107.55130004900008 16.474060058000077, 107.55303192100018 16.476619720000087, 107.55493926999998 16.474199294000016, 107.55797576900017 16.47608947800012, 107.55626678500016 16.47899246200012, 107.56214141800012 16.48314666800013, 107.56152343800017 16.486259462000135, 107.55887603700006 16.486747742000034, 107.55246734600013 16.50489425699999, 107.55093383700017 16.50693512100014, 107.5482025140002 16.504356385000108, 107.54772949200014 16.502576829000134, 107.5487060550002 16.497671127000103, 107.5468978880001 16.496623993000128, 107.5477676390002 16.494499208000093, 107.54577636800019 16.493879319000087, 107.53996276800001 16.502656938000086, 107.53815460300007 16.499040603000083, 107.53527069100005 16.498855592000155, 107.53500366300011 16.49809074400008, 107.5355529790001 16.495742799000084, 107.53371429500004 16.49225235, 107.53436279300007 16.491744996000136, 107.53231048700007 16.489768982000044, 107.53296661300016 16.48868179300007, 107.53321838400012 16.489446641000143, 107.53885650600017 16.48970604100009, 107.53943634100006 16.488615037000045, 107.54125213600014 16.489082337000184, 107.54366302400013 16.48741531400003, 107.54311370800013 16.485773087000098, 107.54380798300014 16.483385087000045, 107.54224395700004 16.481815339000036, 107.54358673000002 16.480360031000032, 107.545143128 16.4812641150001, 107.54943084700011 16.474121093000065, 107.55038452100018 16.473484040000187, 107.55130004900008 16.474060058000077))",Phường An Hòa,11973,5866,6107,452,452,1658
An Tây,"POLYGON ((107.59072875900011 16.443559646000097, 107.58924102700013 16.443151474000103, 107.58837890700005 16.44184303300011, 107.58718109100005 16.439447403000145, 107.58399963400018 16.436880112999972, 107.5855102550002 16.43538665800014, 107.58915710500014 16.42337227000013, 107.58699798700019 16.42255020200014, 107.58816528400007 16.419931411000107, 107.58826446600006 16.417400359999988, 107.5867309570001 16.417240143000186, 107.58825683600014 16.410484314000087, 107.59068298199998 16.408891679000078, 107.59785461300015 16.40630340500013, 107.60856628500005 16.40571594300019, 107.6093368540001 16.404582977000075, 107.60942840600006 16.39912796100009, 107.61119842600016 16.398584366000136, 107.61381530800014 16.40468597400013, 107.6147995 16.40612411500001, 107.61618805000018 16.40612411500001, 107.6117095950001 16.410923003999983, 107.61146545400004 16.41385269200009, 107.60980224600007 16.418352127000162, 107.61073303199998 16.419740677000107, 107.6105804450001 16.42107582000017, 107.60880279600019 16.423788072000036, 107.60831451400009 16.42933845500005, 107.61223602199999 16.435132981000038, 107.61228179900019 16.436897279000164, 107.61020660400015 16.44337463500017, 107.61052703900009 16.444553374999998, 107.60937500000006 16.445943833000115, 107.6106033330002 16.446969986000056, 107.60781860300017 16.448776244999976, 107.60506439100004 16.44697761600014, 107.60588073700006 16.44416046200007, 107.60848998900013 16.441343307000125, 107.60770416200006 16.440050126000187, 107.60135650699999 16.440578461000086, 107.59475708100001 16.439842224000017, 107.59201049700016 16.440710068000044, 107.59240722600003 16.443454743000075, 107.59072875900011 16.443559646000097))",Phường An Tây,11887,5757,6130,485,243,792
Đúc,"POLYGON ((107.55380233959863 16.451570713020544, 107.55583190900006 16.448566438000114, 107.55737304600012 16.44866943300002, 107.56321716300005 16.45178604100016, 107.56311798100018 16.452701569000055, 107.5644073480002 16.453252793000047, 107.56728363100007 16.452859879000187, 107.57257843100012 16.455280305000088, 107.57302856500007 16.453401565000092, 107.57401275600006 16.45336723300005, 107.57436370800013 16.455835344000093, 107.57523345900006 16.452411651000034, 107.57727813700012 16.449319841000033, 107.57853698800011 16.45083618199999, 107.57929229800004 16.45437050000004, 107.58057403600009 16.455139161000147, 107.5803985600001 16.456842423000012, 107.57681274500015 16.458440781000093, 107.57651182474967 16.459520939606023, 107.57454209313647 16.459514493908046, 107.5722340790386 16.45892327604315, 107.56907523383222 16.45711923176316, 107.5655341085228 16.455742313437838, 107.56223379005502 16.454749665814177, 107.55851537328925 16.453410810652144, 107.55635787696718 16.45229709152204, 107.55380233959863 16.451570713020544))",Phường Phường Đúc,10370,5089,5281,494,494,864
Hương Long,"POLYGON ((107.54224395700004 16.481815339000036, 107.5397491450002 16.480543137000097, 107.53933715900007 16.478017808000175, 107.53494262800012 16.477396012000042, 107.5326461800002 16.474657058000105, 107.53123474100005 16.474369050000064, 107.53060150200014 16.4722957620001, 107.52724456700014 16.472063064000054, 107.5260314950001 16.471282960000167, 107.52480316200018 16.468631744000163, 107.52622985900018 16.46487617500003, 107.5270573275248 16.46354300480732, 107.52724849230128 16.463235010999256, 107.5271606450001 16.460762025000122, 107.52989959700005 16.459323882000092, 107.53568267800011 16.45939827100011, 107.53755188000002 16.457157136000035, 107.53651428200016 16.455104827000127, 107.53514862000014 16.45515823400001, 107.53479003800015 16.454238891999978, 107.53356170600011 16.454559326000037, 107.53240966900012 16.453786850000085, 107.53359985300017 16.451910020000014, 107.54234314000018 16.454893112000093, 107.54348754800014 16.454805375000035, 107.54363057469072 16.453337106130903, 107.54425003979571 16.452382097427517, 107.54502412143756 16.451926894575024, 107.54732433982878 16.45186468574957, 107.5493023627364 16.452650470881792, 107.55266665357289 16.45381627402594, 107.55670860006626 16.45625002571643, 107.55493926999998 16.458986282000012, 107.55642700200019 16.459095001000037, 107.55720520100016 16.45992851300008, 107.55284881700015 16.466590882000048, 107.55307006700014 16.467803954999965, 107.5522537240002 16.469161988000167, 107.55362701300004 16.470851898000035, 107.55130004900008 16.474060058000077, 107.55038452100018 16.473484040000187, 107.54943084700011 16.474121093000065, 107.545143128 16.4812641150001, 107.54358673000002 16.480360031000032, 107.54224395700004 16.481815339000036))",Phường Hương Long,13122,6396,6726,673,34,3350
Hương Sơ,"POLYGON ((107.56214141800012 16.48314666800013, 107.56347656200012 16.484043121000127, 107.56387329100016 16.486270905000083, 107.57304382300009 16.492940903000033, 107.57244110000005 16.493490218000147, 107.56778717000009 16.492498399000056, 107.56750488300008 16.49537277200011, 107.56941986100009 16.49567794800015, 107.56915283100017 16.49882698099998, 107.570579528 16.499897003000058, 107.57056426999998 16.502199174000054, 107.56800079400017 16.503810882000153, 107.56777954100005 16.502653123000016, 107.56572723300008 16.502620696000122, 107.56431579600007 16.50402641200003, 107.5629959100001 16.503992080000046, 107.5640640250001 16.507518768000182, 107.56093597300014 16.508289337000065, 107.5537338260001 16.507503510000163, 107.55246734600013 16.50489425699999, 107.55887603700006 16.486747742000034, 107.56152343800017 16.486259462000135, 107.56214141800012 16.48314666800013))",Phường Hương Sơ,12990,6365,6625,545,584,1940
Kim Long,"POLYGON ((107.55130004900008 16.474060058000077, 107.55362701300004 16.470851898000035, 107.5522537240002 16.469161988000167, 107.55307006700014 16.467803954999965, 107.55284881700015 16.466590882000048, 107.55720520100016 16.45992851300008, 107.55642700200019 16.459095001000037, 107.55493926999998 16.458986282000012, 107.55670860006626 16.45625002571643, 107.56961218334266 16.460727613071924, 107.55797576900017 16.47608947800012, 107.55493926999998 16.474199294000016, 107.55303192100018 16.476619720000087, 107.55130004900008 16.474060058000077))",Phường Kim Long,16850,8294,8556,707,758,2516
Phú Hậu,"POLYGON ((107.58019256600011 16.491294861000085, 107.58263397200017 16.489650726000036, 107.59181114526359 16.48843383899998, 107.59207718252691 16.490238260473404, 107.5919556989711 16.492615989367323, 107.59149947740178 16.494745651585674, 107.59033727263488 16.496370313163368, 107.58925673620439 16.497183913665026, 107.58841640936873 16.49794975860374, 107.58683400661909 16.497914480283782, 107.58577944008186 16.496773808064347, 107.58409395864464 16.495411714171382, 107.58259547265527 16.494581057712367, 107.5816397158527 16.49430090272284, 107.58016193934213 16.49431402843527, 107.57890498350542 16.49433390759316, 107.5784858705689 16.494528141661988, 107.57838439900019 16.49407005300003, 107.58019256600011 16.491294861000085))",Phường Phú Hậu,12370,6094,6276,519,556,1847
Phú Hội,"POLYGON ((107.59203628274594 16.470222577383254, 107.58976113533629 16.4680800339803, 107.59936523400017 16.45935440100004, 107.6001434330002 16.464700699000048, 107.59883880700005 16.468587876000072, 107.59987640300011 16.471441270000128, 107.59570312500011 16.47362327500008, 107.59431591433219 16.472766514081002, 107.59312654133089 16.471411950384947, 107.59203628274594 16.470222577383254))",Phường Phú Hội,9446,4674,4772,397,425,1411
Phú Nhuận,"POLYGON ((107.60031890900012 16.456912994000106, 107.59936523400017 16.45935440100004, 107.58976113533629 16.4680800339803, 107.58885861442741 16.46724579938865, 107.59059906100009 16.465068817000144, 107.59214019800015 16.456380844000137, 107.59410095200019 16.456157684000118, 107.59654235900013 16.455518724, 107.60031890900012 16.456912994000106))",Phường Phú Nhuận,8123,4026,4097,325,650,1805
Phước Vĩnh,"POLYGON ((107.59410095200019 16.456157684000118, 107.59214019800015 16.456380844000137, 107.58885955900001 16.45638847400005, 107.58501434400011 16.4545249950001, 107.58345031800019 16.45487022399999, 107.5822601320001 16.45204353400004, 107.58499145500008 16.451501845999985, 107.58557891800012 16.44987678500013, 107.58674621500012 16.450208665000048, 107.58627319300007 16.443695068000125, 107.58837890700005 16.44184303300011, 107.58924102700013 16.443151474000103, 107.59072875900011 16.443559646000097, 107.59134674100011 16.446763993000104, 107.5904693600001 16.44842147900016, 107.5919189450002 16.45008468700007, 107.59276580700009 16.453149795, 107.59368896500013 16.453670502000023, 107.59410095200019 16.456157684000118))",Phường Phước Vĩnh,19817,9796,10021,1651,2064,2050
Tây Lộc,"POLYGON ((107.56552828890779 16.469187637203618, 107.57320404100017 16.474714279000125, 107.57034301700008 16.479263306000178, 107.56542067946214 16.48542316103243, 107.56347656200012 16.484043121000127, 107.56214141800012 16.48314666800013, 107.55857554397403 16.480625084902954, 107.55714436056559 16.47963773815121, 107.55928645943828 16.476838819760303, 107.56138282707741 16.47428270477735, 107.56318483268706 16.47208955864545, 107.56552828890779 16.469187637203618))",Phường Tây Lộc,23307,11430,11877,568,2274,3586
Thuận Hòa,"POLYGON ((107.58161163200009 16.467353821000017, 107.5805130010001 16.468540192000034, 107.5764617910001 16.465614319000167, 107.57299804600012 16.470085144000166, 107.57575225800008 16.472255707999977, 107.57361602800006 16.474987031000126, 107.57320404100017 16.474714279000125, 107.56552828890779 16.469187637203618, 107.57157382284186 16.461218022946753, 107.57346397953239 16.461493112296637, 107.57596627113082 16.46219929935569, 107.58032948084258 16.463926934361382, 107.58333822074087 16.465572022481183, 107.58161163200009 16.467353821000017))",Phường Thuận Hòa,16528,8130,8398,1653,331,2960
Thuỷ Biều,"POLYGON ((107.55380233959863 16.451570713020544, 107.54997920265896 16.450474879216245, 107.54722109564472 16.44982561311241, 107.54518458288362 16.450230405908485, 107.54270137703327 16.450291402698156, 107.54003485041437 16.45034250311255, 107.53634452179409 16.44903008154398, 107.53314976416408 16.447649673079297, 107.53145316128172 16.446953887664904, 107.52934304213085 16.44678165336859, 107.5291274848214 16.44540771759864, 107.52885699324315 16.44339855790065, 107.52921832968121 16.441967732000023, 107.52989943874763 16.440911415821347, 107.53259400983728 16.438572305549428, 107.53451356253362 16.437092036698687, 107.53685784672956 16.43613215850644, 107.54086276315081 16.434903472720976, 107.54529126064574 16.433860979388783, 107.54852719549609 16.432984252437507, 107.55209433288906 16.43176192205499, 107.55557279820022 16.430557262827108, 107.55918192283599 16.429744352380794, 107.56077238474961 16.429251089276306, 107.56213314423036 16.42797571604615, 107.56315558213714 16.42751948819688, 107.56483607910502 16.425256977184404, 107.56535841208154 16.425037438751076, 107.56608581500006 16.42490959200012, 107.56680540667787 16.42618320563173, 107.56580645104623 16.428367244723916, 107.56466674799998 16.428659440000047, 107.56278228700012 16.431285858000138, 107.5631332390002 16.432312012000125, 107.56123352000014 16.440227510000113, 107.55898284900019 16.44246673700019, 107.55769348100006 16.445383072000027, 107.55737304600012 16.44866943300002, 107.55583190900006 16.448566438000114, 107.55380233959863 16.451570713020544))",Phường Thuỷ Biều,10488,5161,5327,440,472,1566
Thuỷ Xuân,"POLYGON ((107.58399963400018 16.436880112999972, 107.57935333200015 16.435689927000112, 107.57893371600005 16.437253953000038, 107.58055877800007 16.440734863999978, 107.57727813700012 16.449319841000033, 107.57523345900006 16.452411651000034, 107.57436370800013 16.455835344000093, 107.57401275600006 16.45336723300005, 107.57302856500007 16.453401565000092, 107.57257843100012 16.455280305000088, 107.56728363100007 16.452859879000187, 107.5644073480002 16.453252793000047, 107.56311798100018 16.452701569000055, 107.56321716300005 16.45178604100016, 107.55737304600012 16.44866943300002, 107.55769348100006 16.445383072000027, 107.55898284900019 16.44246673700019, 107.56123352000014 16.440227510000113, 107.5631332390002 16.432312012000125, 107.56278228700012 16.431285858000138, 107.56466674799998 16.428659440000047, 107.56580645104623 16.428367244723916, 107.56680540667787 16.42618320563173, 107.56608581500006 16.42490959200012, 107.57134246800007 16.423694610000155, 107.571662903 16.420522689000165, 107.57590484700017 16.42255592400005, 107.57733917200011 16.424089431000027, 107.57983398400012 16.424507141000163, 107.58059692400019 16.42106628400012, 107.58263397200017 16.420396805000053, 107.58354187000015 16.417573927999968, 107.5867309570001 16.417240143000186, 107.58826446600006 16.417400359999988, 107.58816528400007 16.419931411000107, 107.58699798700019 16.42255020200014, 107.58915710500014 16.42337227000013, 107.5855102550002 16.43538665800014, 107.58399963400018 16.436880112999972))",Phường Thuỷ Xuân,21250,10500,10750,46,924,4474
Trường An,"POLYGON ((107.58837890700005 16.44184303300011, 107.58627319300007 16.443695068000125, 107.58674621500012 16.450208665000048, 107.58557891800012 16.44987678500013, 107.58499145500008 16.451501845999985, 107.5822601320001 16.45204353400004, 107.58345031800019 16.45487022399999, 107.5803985600001 16.456842423000012, 107.58057403600009 16.455139161000147, 107.57929229800004 16.45437050000004, 107.57853698800011 16.45083618199999, 107.57727813700012 16.449319841000033, 107.58055877800007 16.440734863999978, 107.57893371600005 16.437253953000038, 107.57935333200015 16.435689927000112, 107.58399963400018 16.436880112999972, 107.58718109100005 16.439447403000145, 107.58837890700005 16.44184303300011))",Phường Trường An,16549,8098,8451,1504,38,2106
Vĩ Dạ,"POLYGON ((107.59318336713716 16.47496273823623, 107.59417791075174 16.475065843835864, 107.59463943846731 16.474019239670042, 107.59590477379737 16.474349210670027, 107.59784270490275 16.47370204154379, 107.59931675367005 16.473018701986575, 107.6007233279484 16.471441270000128, 107.602399613189 16.470932048632278, 107.60309054144335 16.47109035863224, 107.60539567784917 16.47224589524069, 107.60648013257094 16.474550563391745, 107.60389709400016 16.476713180000047, 107.60392761300011 16.479616166000085, 107.60311126700009 16.480905533000055, 107.60337066700004 16.48187065100018, 107.60581970200008 16.48392486500012, 107.60383605900017 16.483501435000107, 107.59943390000018 16.484556199000167, 107.59692382700007 16.486240386000134, 107.596321106 16.489124299000082, 107.59422466155746 16.48937926886117, 107.59483611452907 16.486698354312296, 107.59535856366637 16.484836478535215, 107.59511633040711 16.483712067111867, 107.59422977895673 16.484134235702072, 107.59371632309956 16.485530096320645, 107.59237271000637 16.48543243968993, 107.59197529360102 16.484027614007857, 107.59183614535397 16.481878006240663, 107.59249276724682 16.48035084524497, 107.59286329930393 16.477812594965826, 107.59318336713716 16.47496273823623))",Phường Vỹ Dạ,19495,9707,9788,34,672,1978
Vĩnh Ninh,"POLYGON ((107.58447891337886 16.46312532552571, 107.58290584967392 16.462212770405017, 107.58125583878956 16.461877408681005, 107.58009466420464 16.461748010630174, 107.57924948534583 16.460890262193118, 107.57791887497285 16.460239734843242, 107.57651182474967 16.459520939606023, 107.57681274500015 16.458440781000093, 107.5803985600001 16.456842423000012, 107.58345031800019 16.45487022399999, 107.58501434400011 16.4545249950001, 107.58885955900001 16.45638847400005, 107.59214019800015 16.456380844000137, 107.59059906100009 16.465068817000144, 107.58885861442741 16.46724579938865, 107.58670095353108 16.465189861875956, 107.58498466533524 16.46340645579022, 107.58447891337886 16.46312532552571))",Phường Vĩnh Ninh,6299,3165,3134,264,283,941
Xuân Phú,"POLYGON ((107.60153198300014 16.456869125000082, 107.60128784200009 16.459173203000148, 107.60263824500004 16.4594593060001, 107.60556030200013 16.46263122500011, 107.60614013700001 16.46281814600019, 107.60698699900013 16.46169471800016, 107.60824585000012 16.462465287000043, 107.61019134600014 16.4618186940001, 107.610671997 16.463220596999975, 107.61363983100006 16.463214875000062, 107.61365509100011 16.466186524000022, 107.61177825800013 16.466159820000087, 107.6118774410001 16.47034645100001, 107.6127243050002 16.470386506000068, 107.61280059900008 16.471296311000117, 107.61487579300001 16.470512391000057, 107.61586761500001 16.472568513, 107.6131439200002 16.473743438000156, 107.6072463980002 16.473945617000084, 107.6060409540001 16.47228622500012, 107.60333251999998 16.470525742000007, 107.60159301800013 16.470367432000046, 107.59987640300011 16.471441270000128, 107.59883880700005 16.468587876000072, 107.6001434330002 16.464700699000048, 107.59936523400017 16.45935440100004, 107.60031890900012 16.456912994000106, 107.60153198300014 16.456869125000082))",Phường Xuân Phú,15216,7484,7732,639,684,2272
Thủy Bằng,"POLYGON ((107.5867309570001 16.417240143000186, 107.58354187000015 16.417573927999968, 107.58263397200017 16.420396805000053, 107.58059692400019 16.42106628400012, 107.57983398400012 16.424507141000163, 107.57733917200011 16.424089431000027, 107.57590484700017 16.42255592400005, 107.571662903 16.420522689000165, 107.57134246800007 16.423694610000155, 107.56608581500006 16.42490959200012, 107.56535841208154 16.425037438751076, 107.56517276284177 16.421869304309382, 107.56528973264165 16.420193122786202, 107.56461460401857 16.420405627430284, 107.56435072115102 16.41926232958565, 107.56493615605126 16.416360987836754, 107.5655615288519 16.414289384478536, 107.56618340865765 16.412821982447554, 107.56771770921466 16.40998155052091, 107.56969991488768 16.407032163401652, 107.57184236353356 16.404612695356718, 107.57422426657479 16.401627728918413, 107.5760241895195 16.399548169151217, 107.57623473757013 16.397574336655737, 107.57648070187332 16.396236373146508, 107.57698114421953 16.39429704112672, 107.57709602073692 16.393087660493734, 107.57695924629746 16.390261020642868, 107.57681373473679 16.389321414355493, 107.57735834342827 16.38790952693961, 107.57846024379569 16.38631736866489, 107.58089109774971 16.38419901990801, 107.58468993717514 16.38182871148365, 107.58750847627346 16.379824038599963, 107.58933480596414 16.377975944537297, 107.59062308841175 16.37753385011615, 107.59209739021009 16.37806285057843, 107.59424892150668 16.378888611049774, 107.5955430849736 16.379036264617355, 107.59682834893567 16.37973479137952, 107.59800511828928 16.378989132644733, 107.60029208280321 16.377137960129403, 107.60255043631986 16.375112567115707, 107.60410115822685 16.37379876197531, 107.60596845778394 16.371792606320184, 107.60671917582886 16.37055384790807, 107.60682029313818 16.369409189723854, 107.60668963280375 16.367119853630868, 107.60607009875747 16.364874314901897, 107.60628137778264 16.362996958217366, 107.60651151262573 16.361077176430115, 107.60691759142372 16.359188872586174, 107.60721649165964 16.357393625131465, 107.6075754517368 16.355638009631775, 107.6081556462454 16.35445437959936, 107.60843658400006 16.353364945000123, 107.6099887874247 16.352121851354696, 107.6112628774145 16.35204830170369, 107.61279668621745 16.353632468368573, 107.61402396733547 16.35363390181675, 107.61531066900011 16.35289192200014, 107.61733245800019 16.34628105200011, 107.62059021100015 16.34067535500003, 107.62800598100017 16.340070724000157, 107.63458251900005 16.340818404000004, 107.63409423900015 16.34281349200006, 107.63214874300013 16.345113755000057, 107.63076019300019 16.344638825000004, 107.629226684 16.345331193000106, 107.62771606500019 16.34433364900019, 107.62522888100011 16.34674835200002, 107.62425994800014 16.346328735000043, 107.6238098140002 16.35154151900008, 107.62339019699999 16.35188102799998, 107.62275695800008 16.350809097000024, 107.62209320100015 16.351266861000056, 107.62200164700005 16.352167131000158, 107.623329162 16.352413178000177, 107.6236038200002 16.353963853000096, 107.62516784600012 16.354339600000003, 107.62557220500008 16.355228424000018, 107.62258148200016 16.35691070600012, 107.62057495100015 16.356931686999985, 107.61822509800015 16.364791870000147, 107.61558532700013 16.367313386000035, 107.61676788400018 16.36849784900005, 107.61741638199999 16.37143898100004, 107.62103271400008 16.37359237700008, 107.6203308110002 16.376136779000092, 107.62064361600005 16.378732681000088, 107.6200561510002 16.379486084000177, 107.62242126400002 16.381875993000108, 107.6199874880001 16.38599777100012, 107.61983490099999 16.388061523000147, 107.62093353200004 16.388891220000176, 107.62089538600009 16.390008927000167, 107.61350250200019 16.39026641900017, 107.6132125850001 16.391046525000036, 107.611457825 16.39027786200012, 107.6099624630001 16.392419815000153, 107.61119842600016 16.398584366000136, 107.60942840600006 16.39912796100009, 107.6093368540001 16.404582977000075, 107.60856628500005 16.40571594300019, 107.59785461300015 16.40630340500013, 107.59068298199998 16.408891679000078, 107.58825683600014 16.410484314000087, 107.5867309570001 16.417240143000186))",Xã Thủy Bằng,8340,4102,4238,350,375,1246
Thủy Vân,"POLYGON ((107.62377929800016 16.47227287400017, 107.62698364300013 16.47262764000004, 107.62703704800003 16.474042892000057, 107.63039398300003 16.475614548000067, 107.62981414800015 16.476699829000097, 107.63380432100013 16.478496551000035, 107.6323318490002 16.483669281000118, 107.6314315790001 16.484182357000122, 107.63290405300006 16.489068986000063, 107.6238784800002 16.491458893000186, 107.61814880400004 16.48934936600017, 107.61492919900019 16.489324570000065, 107.60997772200005 16.488664627000105, 107.6089630140001 16.48738288900006, 107.60864257900016 16.48513984700014, 107.60581970200008 16.48392486500012, 107.60337066700004 16.48187065100018, 107.60311126700009 16.480905533000055, 107.60392761300011 16.479616166000085, 107.60389709400016 16.476713180000047, 107.6072463980002 16.473945617000084, 107.6131439200002 16.473743438000156, 107.61586761500001 16.472568513, 107.61894226100003 16.473211288000186, 107.62377929800016 16.47227287400017))",Phường Thủy Vân,8205,4075,4130,344,369,1225
Hải Dương,"POLYGON ((107.57128145331626 16.60398697412745, 107.57013262219039 16.59919869245499, 107.57151382727403 16.59799187540125, 107.57707292439375 16.594623973501825, 107.57577268984545 16.59275846842519, 107.57872306737227 16.59104786851708, 107.58136172256991 16.589128795870124, 107.58355799927494 16.587485097363583, 107.58594433809839 16.58454644986648, 107.58805412579738 16.583853126023712, 107.59049002460858 16.583752119288135, 107.59421110974552 16.581680718972166, 107.59495507152462 16.58306945198484, 107.59777802579214 16.58077219168797, 107.59703742172445 16.578841734274874, 107.59756171529779 16.57777534559756, 107.59973984868753 16.57536583966572, 107.60272861378786 16.572621288671257, 107.60456236835915 16.57085280920279, 107.60457153112372 16.56963780444198, 107.60668951618646 16.567695113237107, 107.60895018455238 16.566740903910613, 107.60990032596237 16.567280850439033, 107.61766640630617 16.564957120602003, 107.61940561545316 16.56475433513714, 107.61987970591923 16.565197982439486, 107.622803567929 16.565346501363592, 107.62256656736474 16.567048932477007, 107.62099515192466 16.56853920158852, 107.6195344376656 16.56933771656071, 107.61851246420918 16.570205067326867, 107.61875582011578 16.571042969478754, 107.61823099762813 16.572467981019372, 107.61669452660323 16.573364631568893, 107.61886797753249 16.573538152027538, 107.61829170368873 16.574375210616893, 107.61577088745742 16.574994619756183, 107.61546288431106 16.575848493910655, 107.61581647013463 16.576914704934154, 107.61582467290003 16.577978201489145, 107.61461817763774 16.578546142521816, 107.61344122082482 16.579566043988393, 107.61212069044859 16.581470842454223, 107.60896356116206 16.582486366915703, 107.60390193921899 16.584621490484324, 107.59626007100002 16.58825302100007, 107.58152203917808 16.597378807527093, 107.5792332223005 16.59866888790077, 107.57128145331626 16.60398697412745))",Xã Hải Dương,5738,2865,2873,241,258,857
Hương An,"POLYGON ((107.53296661300016 16.48868179300007, 107.53310245789515 16.4854642662562, 107.53049423562516 16.484419225760803, 107.52833314028743 16.48326575452495, 107.52833071564459 16.482041174862047, 107.52824401900006 16.481195449999973, 107.52598077618148 16.48032084445856, 107.52186152817688 16.478669971598663, 107.5208254868358 16.480069491522443, 107.51962280200019 16.48016929700009, 107.51811658367785 16.478944536970175, 107.51731156254863 16.478546821622217, 107.51671418158526 16.47989180383439, 107.51539611900017 16.479507446000127, 107.51576247840165 16.477879287243127, 107.51389327640169 16.476710726012982, 107.51236300898103 16.47696506883267, 107.51154856629347 16.476503299209583, 107.51213692073475 16.475508908290465, 107.51189665367781 16.474803795453226, 107.50983968488771 16.474349227992718, 107.507904053 16.474346161000028, 107.50632476900012 16.473321914999985, 107.50563929145693 16.472558413728223, 107.50313011792309 16.466842826143477, 107.49951380171109 16.460744831690818, 107.49799797239837 16.458935189005842, 107.4953492350457 16.45573719396816, 107.49578094500004 16.454410552000184, 107.49747467000014 16.45239448500007, 107.50140380900007 16.450843812000073, 107.50173187200011 16.444906233999973, 107.50579834000013 16.443147659000033, 107.50949859600007 16.444820405000087, 107.51753997700007 16.445316316000174, 107.51694488500004 16.447469712000157, 107.51752471900005 16.44842147900016, 107.52230835000017 16.44802856500013, 107.52603912300003 16.451107025000113, 107.52729797400019 16.450551986000107, 107.5277862550002 16.451023103000125, 107.5258255010001 16.451869965000185, 107.52379623040162 16.459457026723783, 107.52399969348642 16.460237016086637, 107.52482991661896 16.460337238442207, 107.52638081349369 16.46072730186927, 107.5271606450001 16.460762025000122, 107.52724849230128 16.463235010999256, 107.52622985900018 16.46487617500003, 107.52480316200018 16.468631744000163, 107.5260314950001 16.471282960000167, 107.52724456700014 16.472063064000054, 107.53060150200014 16.4722957620001, 107.53123474100005 16.474369050000064, 107.5326461800002 16.474657058000105, 107.53494262800012 16.477396012000042, 107.53933715900007 16.478017808000175, 107.5397491450002 16.480543137000097, 107.54224395700004 16.481815339000036, 107.54380798300014 16.483385087000045, 107.54311370800013 16.485773087000098, 107.54366302400013 16.48741531400003, 107.54125213600014 16.489082337000184, 107.53943634100006 16.488615037000045, 107.53885650600017 16.48970604100009, 107.53321838400012 16.489446641000143, 107.53296661300016 16.48868179300007))",Phường Hương An,6465,3234,3231,271,291,966
Hương Hồ,"POLYGON ((107.52482991661896 16.460337238442207, 107.52399969348642 16.460237016086637, 107.52379623040162 16.459457026723783, 107.5258255010001 16.451869965000185, 107.5277862550002 16.451023103000125, 107.52729797400019 16.450551986000107, 107.52603912300003 16.451107025000113, 107.52230835000017 16.44802856500013, 107.51752471900005 16.44842147900016, 107.51694488500004 16.447469712000157, 107.51753997700007 16.445316316000174, 107.50949859600007 16.444820405000087, 107.50579834000013 16.443147659000033, 107.50173187200011 16.444906233999973, 107.50140380900007 16.450843812000073, 107.49747467000014 16.45239448500007, 107.49578094500004 16.454410552000184, 107.49378967200005 16.455144882000184, 107.48979187000003 16.45169067400019, 107.48692321800019 16.45096778800007, 107.48294067400019 16.452318192000064, 107.479606628 16.45207977300015, 107.47666168200004 16.444776535000187, 107.47344970600005 16.442636490000098, 107.46806335400004 16.436714173000098, 107.46825409000002 16.433929444, 107.4714279170002 16.42610359300005, 107.47305297800006 16.425905229000023, 107.47463989200008 16.42368507500015, 107.4877014160001 16.411569595000117, 107.49124145500014 16.41178321900003, 107.49385070700004 16.412940979000098, 107.50292968800011 16.409584046000077, 107.5157089240002 16.41142273000014, 107.51771545300005 16.409484864000035, 107.51788330100004 16.405994416000055, 107.52046966500018 16.404573440999968, 107.52146148600008 16.40528488200016, 107.52512359500014 16.405616761000147, 107.52690124600002 16.40665245100007, 107.52806091300016 16.40652084300018, 107.53009796100014 16.40276908900006, 107.53199005200008 16.403934479000043, 107.53392791800002 16.402238847000092, 107.5347671520002 16.403453827000078, 107.53601837100007 16.40301895100015, 107.53839874200014 16.40820312400018, 107.54033660800008 16.40969467200017, 107.5415267940001 16.41248893800008, 107.54277801500018 16.413215637000064, 107.54166412300003 16.41803741500007, 107.54647827100007 16.420204162000175, 107.54800415000011 16.421838761000174, 107.54894256600016 16.424255371000072, 107.551681519 16.424119949999977, 107.55383300800014 16.423156738000046, 107.55675506500006 16.423315048000177, 107.55981445300006 16.42230415300014, 107.56310787915851 16.42233390313811, 107.56260342362248 16.42495208420297, 107.56043122838196 16.427586937165245, 107.55636353544799 16.428652595646156, 107.552739288709 16.4295445490489, 107.54809045831956 16.43055949986683, 107.54505998792774 16.431862160833305, 107.54016206416486 16.432939600818543, 107.53416220560871 16.434517354938635, 107.52970532097083 16.437623141621884, 107.5268292129386 16.441207845368012, 107.52574623779026 16.44406554320443, 107.52585855091547 16.445749211526902, 107.52752988228372 16.447599163815823, 107.5298975723631 16.448604681782854, 107.53229284032074 16.44890968046161, 107.5343268429491 16.44998804116136, 107.53796996673111 16.451736299598792, 107.54075381917073 16.452764336559596, 107.54363057469072 16.453337106130903, 107.54348754800014 16.454805375000035, 107.54234314000018 16.454893112000093, 107.53359985300017 16.451910020000014, 107.53240966900012 16.453786850000085, 107.53356170600011 16.454559326000037, 107.53479003800015 16.454238891999978, 107.53514862000014 16.45515823400001, 107.53651428200016 16.455104827000127, 107.53755188000002 16.457157136000035, 107.53568267800011 16.45939827100011, 107.52989959700005 16.459323882000092, 107.5271606450001 16.460762025000122, 107.52638081349369 16.46072730186927, 107.52482991661896 16.460337238442207))",Phường Hương Hồ,10584,5224,5360,444,476,1581
Hương Phong,"POLYGON ((107.5808381602983 16.57668156140528, 107.58029096823282 16.57575446391388, 107.57873286232734 16.574267761739577, 107.5792340291033 16.573096182318352, 107.57897221525877 16.57229980003291, 107.58154477576346 16.569252812064633, 107.58301400405912 16.566911599217406, 107.58313744539964 16.565011910881367, 107.58302470450678 16.562837802020397, 107.5825852729539 16.562212908263575, 107.58093209597303 16.56141159251007, 107.57969985416628 16.56148362736127, 107.57871246400003 16.560750962000157, 107.57895680054145 16.558917967050377, 107.57971954300012 16.557567596000183, 107.58010117716549 16.555667362572706, 107.57961743895402 16.55448802217137, 107.57868091246144 16.552176713267613, 107.57725852674344 16.54985755017657, 107.5760315066982 16.54798551235774, 107.57533670318429 16.546849709631886, 107.57553100500013 16.54495620700004, 107.57484893570808 16.543328742672486, 107.57258829437671 16.5395663974478, 107.57107008927642 16.537357974769975, 107.57120259667028 16.536436597131797, 107.57139636936859 16.53559253763183, 107.57066756079848 16.534954734646988, 107.56934406136861 16.533741121092305, 107.56922912700009 16.532812118000038, 107.5698892529199 16.532146382041958, 107.57167053100011 16.530973435000078, 107.57193689055748 16.53006115655188, 107.57136406746059 16.52931010190798, 107.57240295300016 16.529008865000037, 107.57372545631927 16.527712526516893, 107.5747820354606 16.527781619519544, 107.57539289797921 16.52908400791756, 107.57652282600009 16.53031539900013, 107.57694302975062 16.53175800127991, 107.57847283338867 16.53391580392082, 107.57988527133307 16.535152934256246, 107.58131746020564 16.536208018077104, 107.5819057297843 16.536744502483884, 107.58266719053546 16.53712185630212, 107.58349947643876 16.537554515683667, 107.58484276429732 16.537982939083008, 107.58635771560608 16.53896420895387, 107.58747996186821 16.540803988077585, 107.58876374303509 16.543155948599576, 107.58984302434743 16.544876675835837, 107.59147882190524 16.54677999036511, 107.59287660295814 16.548103299208606, 107.59342695332111 16.549039527494415, 107.5945129391452 16.549870027022564, 107.59573213301712 16.550497115830296, 107.59849056030367 16.55112123191799, 107.60056858194719 16.551209639287606, 107.60222421164326 16.550820893699722, 107.60387990269084 16.550510504782835, 107.60527022929239 16.549940931362414, 107.60783304329942 16.549752362744982, 107.6100139808546 16.54897090350653, 107.61217634166434 16.548231440794837, 107.6146174916542 16.54820952318329, 107.61679642084647 16.54816343937165, 107.61877409057473 16.548211054660783, 107.62034369152155 16.548100962723822, 107.62239893245345 16.547908740768094, 107.62443415247958 16.547943635544414, 107.62575630073678 16.548278473974108, 107.6269372827627 16.549073154362134, 107.62770901168898 16.550044005532072, 107.62839317011009 16.551464016306966, 107.6288372730956 16.552693259790146, 107.6289266923468 16.55357142633801, 107.62870773515294 16.5544352929939, 107.62813966296272 16.555167304429688, 107.62817984408429 16.559105041969303, 107.62792531401811 16.559743710159637, 107.62712177074599 16.560566174981034, 107.62649396676403 16.560808854942138, 107.62474364121238 16.560861140252996, 107.62258718961124 16.560621619316578, 107.61931992278028 16.560804664344403, 107.61887349713436 16.560284619274285, 107.61939491924835 16.559794033896992, 107.62050973192379 16.559077805957997, 107.62274294952698 16.55892097062076, 107.62354687509679 16.556955334034114, 107.62406195982652 16.55522482439062, 107.62583861447746 16.55223769829513, 107.62350734008157 16.55140964098871, 107.62303635362122 16.5520638045449, 107.62166917609164 16.55197312393591, 107.61973411344695 16.55174513452795, 107.61966979707887 16.552772605416067, 107.61909862249001 16.55366045147656, 107.61795582205355 16.553138551379902, 107.61633264885268 16.552719411457815, 107.61402495255129 16.55366937709624, 107.61330262870058 16.555458009549398, 107.6116680866142 16.555602874884414, 107.60972115458526 16.557050298233776, 107.60741711137854 16.55752916174157, 107.60532025870378 16.557916136407584, 107.6036712769494 16.559251266342358, 107.60286828573032 16.560237145472513, 107.60126803390006 16.560280051373923, 107.60004831990551 16.559789785939074, 107.59919580273083 16.558952789322916, 107.59783395178647 16.558788917294237, 107.59688823608639 16.558719393175693, 107.59618532817848 16.55983592077996, 107.59494212601294 16.560066203093527, 107.59482863199588 16.56104152701414, 107.59503104916445 16.561829647504112, 107.59649762719005 16.562368024719092, 107.59825214335615 16.562807767792492, 107.59913309562427 16.563491015576176, 107.59907418122668 16.564387956479607, 107.59832087315493 16.56455825732985, 107.59779987429664 16.56506629531856, 107.59743888559848 16.56554040979779, 107.59657901158653 16.565876586623915, 107.59515791706605 16.565333687499333, 107.59367109391115 16.56468592360187, 107.59248258270685 16.564501288855638, 107.59141670181145 16.56673065576092, 107.58976092701863 16.56872644837921, 107.58949900742954 16.569224611090306, 107.59037818373054 16.56994799690375, 107.58996225146961 16.570859429007214, 107.58870451090229 16.5715542799378, 107.58849836412332 16.572471565560193, 107.58957915428545 16.573055892256548, 107.58964389667358 16.574847900568784, 107.58919991460078 16.576415011161032, 107.58851896478961 16.57642173701589, 107.58771608376003 16.576437943439828, 107.58758735005546 16.576670149659606, 107.58877197685655 16.578123698060892, 107.58857949622973 16.57935339445345, 107.58775084600643 16.57957817152345, 107.58651090089717 16.5797932245639, 107.5864712994076 16.57936335631001, 107.58379891421254 16.579433432463077, 107.58238569637109 16.57907067135926, 107.58093487217309 16.578215010393535, 107.5808381602983 16.57668156140528))",Xã Hương Phong,9275,4571,4704,389,417,1385
Hương Thọ,"POLYGON ((107.6079203630793 16.353364945000123, 107.60665032551776 16.354829624995716, 107.60615584420464 16.35708342820999, 107.6058773276036 16.359067459648713, 107.60495300910111 16.36188034197113, 107.60473271502036 16.363848722736748, 107.60533636490084 16.365711821039895, 107.60537487455997 16.368789724619035, 107.60535119038872 16.37070871418433, 107.60310572920923 16.37316391592543, 107.60053543538271 16.375575552320925, 107.59848565796881 16.377011259938058, 107.59666294389507 16.378318045447543, 107.59451221065592 16.377839161591794, 107.59261642783792 16.37697263310565, 107.59106494836857 16.37659162095423, 107.58999548275506 16.376548879431027, 107.58843183984129 16.377664141296805, 107.58682791574535 16.37876508995049, 107.58497280915412 16.380038452642225, 107.58288304325833 16.38158392472087, 107.58038004740439 16.3832226843312, 107.57887783615848 16.384482941414433, 107.57662765952682 16.38747886573674, 107.57557480452681 16.389992501552513, 107.57562479111255 16.393371582000157, 107.57513373937763 16.395904268865365, 107.57408836106657 16.3984641052175, 107.5732824540732 16.400472969943223, 107.57144841378624 16.402328324251982, 107.5700338069338 16.404245197069827, 107.56724786551382 16.407006352355552, 107.56606305363539 16.409536366530972, 107.56490573509802 16.410957482169465, 107.56427339125071 16.412073462112403, 107.5632432911699 16.41510405419723, 107.56224597439353 16.418225407251327, 107.56200191596139 16.420294771427336, 107.56207172201266 16.421163129108038, 107.56283866380397 16.421679738683395, 107.56310787915851 16.42233390313811, 107.55981445300006 16.42230415300014, 107.55675506500006 16.423315048000177, 107.55383300800014 16.423156738000046, 107.551681519 16.424119949999977, 107.54894256600016 16.424255371000072, 107.54800415000011 16.421838761000174, 107.54647827100007 16.420204162000175, 107.54166412300003 16.41803741500007, 107.54277801500018 16.413215637000064, 107.5415267940001 16.41248893800008, 107.54033660800008 16.40969467200017, 107.53839874200014 16.40820312400018, 107.53601837100007 16.40301895100015, 107.5347671520002 16.403453827000078, 107.53392791800002 16.402238847000092, 107.53199005200008 16.403934479000043, 107.53009796100014 16.40276908900006, 107.52806091300016 16.40652084300018, 107.52690124600002 16.40665245100007, 107.52512359500014 16.405616761000147, 107.52506256200013 16.402772905000063, 107.52234649700006 16.397911072000056, 107.52241516100003 16.395227433000116, 107.52337646600006 16.393194199000106, 107.52242279100011 16.391170500999976, 107.53271484300012 16.391500474000054, 107.53743744000013 16.390184402000045, 107.54161071800013 16.384498596000128, 107.54077911400009 16.381364822000023, 107.53730011100009 16.37707519600019, 107.53713989300013 16.374547959000097, 107.53830719000018 16.372680665000132, 107.54322814900013 16.372730255000135, 107.54589080800008 16.37042045600009, 107.54689025800013 16.370862962000103, 107.55387878500011 16.361038209000128, 107.55133819600013 16.3594112400001, 107.55174255300011 16.358222962000184, 107.5508270270002 16.35802650500017, 107.55088806200018 16.356170653999982, 107.54955291700009 16.355421066000133, 107.54858398400012 16.35657882800001, 107.54785919300014 16.35641288700009, 107.54724884000018 16.354238510000187, 107.54579925600012 16.353351594000173, 107.54553985700005 16.351989745000026, 107.54331970300007 16.351716995000004, 107.54226684600008 16.35059929000016, 107.54386138800004 16.346790314000145, 107.54467010600013 16.340984344000105, 107.54359436100003 16.339786531000186, 107.5417327880001 16.339345933000118, 107.54049682600015 16.33641624500001, 107.54288482700014 16.332031250000057, 107.542648316 16.33038520800011, 107.54399871700008 16.328887940000186, 107.54616546600005 16.32803154000004, 107.54611968900008 16.321989059000032, 107.5487594600001 16.323812485000076, 107.55033874400004 16.323135376000096, 107.5558547980001 16.328834535000112, 107.55924987700007 16.329019546000097, 107.55939483600008 16.334569931000033, 107.55857086200012 16.337005615000123, 107.5655136100001 16.339025498000183, 107.56932830900013 16.344293595000067, 107.5708084110002 16.345306397, 107.58172607500006 16.34423446700015, 107.59329986500006 16.346807480000166, 107.59510040200007 16.341606141000113, 107.595817565 16.34153938300011, 107.59671020500014 16.34385681200007, 107.59713745200008 16.344211578000113, 107.59712219200003 16.343397140000036, 107.59774017300009 16.343515396000043, 107.59780120800008 16.34447097800006, 107.60114288300008 16.346628189000114, 107.60121917800012 16.34741211000005, 107.60287475600012 16.34697532700011, 107.6027908320001 16.347930908000023, 107.60349273700018 16.348535538000135, 107.60449981700003 16.347923278999986, 107.6050491330002 16.34934234600007, 107.60556793200004 16.348300935000168, 107.60659027000008 16.348596574, 107.60665130600012 16.34699821400011, 107.60816955600018 16.34805297800017, 107.60752105600017 16.349746705000086, 107.60791778500004 16.350625991000186, 107.6060409540001 16.350543975000107, 107.60687255800013 16.35100364700014, 107.60627746600011 16.352441789000125, 107.6079203630793 16.353364945000123))",Xã Hương Thọ,5233,2607,2626,220,235,782
Hương Vinh,"POLYGON ((107.56347656200012 16.484043121000127, 107.56765747100008 16.487010957000052, 107.57761099314155 16.494581275595124, 107.57674561786837 16.49758778209099, 107.57616715113289 16.498909730860987, 107.5759097023556 16.50067279863174, 107.57647930953868 16.502988342606045, 107.57630790298572 16.50376638310405, 107.57572167805188 16.50539779600018, 107.57566780629259 16.508295656697214, 107.57741972893865 16.51017727429263, 107.57871491953023 16.511727774551446, 107.57859037268395 16.514042197075696, 107.57602976641829 16.518964780681813, 107.57434705983104 16.519156148841205, 107.57429811644766 16.52018693525048, 107.57365319680355 16.52118665812884, 107.57333290166491 16.52414998235554, 107.57342369701001 16.52583531987966, 107.57372545631927 16.527712526516893, 107.57240295300016 16.529008865000037, 107.57110595700016 16.52936172400001, 107.56619262700002 16.528377533000025, 107.56089782700019 16.530408859999966, 107.55862426700014 16.527097703000038, 107.5624008170002 16.52256202799998, 107.55941772500012 16.521926881000127, 107.55769348100006 16.520654679000188, 107.55713653499998 16.518299103000174, 107.55487060600018 16.518907547000026, 107.55415344300008 16.51770973300006, 107.5523300170002 16.51703453100015, 107.552398681 16.517835617000173, 107.55155944900002 16.51801109200005, 107.55021667600005 16.514657975000148, 107.55210876500018 16.513914108000165, 107.55087280200019 16.512109756000086, 107.55286407500017 16.509878159000095, 107.5537338260001 16.507503510000163, 107.56093597300014 16.508289337000065, 107.5640640250001 16.507518768000182, 107.5629959100001 16.503992080000046, 107.56431579600007 16.50402641200003, 107.56572723300008 16.502620696000122, 107.56777954100005 16.502653123000016, 107.56800079400017 16.503810882000153, 107.57056426999998 16.502199174000054, 107.570579528 16.499897003000058, 107.56915283100017 16.49882698099998, 107.56941986100009 16.49567794800015, 107.56750488300008 16.49537277200011, 107.56778717000009 16.492498399000056, 107.57244110000005 16.493490218000147, 107.57304382300009 16.492940903000033, 107.56387329100016 16.486270905000083, 107.56347656200012 16.484043121000127))",Phường Hương Vinh,14190,6943,7247,596,638,2119
Phú Dương,"POLYGON ((107.62187957700007 16.52857017499997, 107.6200561510002 16.532083512000156, 107.61656189000018 16.530889511000055, 107.61573791600006 16.52926445000014, 107.60520172000008 16.53152847300015, 107.60566711400008 16.528249742000014, 107.60499572800012 16.528341294000143, 107.60482025200014 16.523685456000067, 107.60303497300015 16.52459907600013, 107.59991455000016 16.521097184000098, 107.59442138700012 16.522171020000144, 107.59439086900011 16.516698837999968, 107.59214782800007 16.515958786000056, 107.59096527100019 16.514429092000114, 107.59216308600008 16.511327744000027, 107.59451293900008 16.509922028000062, 107.59315490800009 16.507606507000048, 107.59605407700002 16.50410652100004, 107.59867858900014 16.50239372300007, 107.59980774000002 16.50460624699997, 107.60174560600012 16.50633621300011, 107.60157775800013 16.508985519000134, 107.60478210500014 16.50946235700013, 107.60483550999999 16.508356095000067, 107.61033630300011 16.509235383000032, 107.61491394000006 16.50810813800007, 107.61616516100014 16.512878419000174, 107.61914062600005 16.513114930000086, 107.61898803600019 16.51561737000003, 107.62139129600007 16.515581131000147, 107.62142944300012 16.519643784000095, 107.61541748100007 16.521102905000134, 107.61918640099998 16.52612495500017, 107.61987304700017 16.528036117000056, 107.62187957700007 16.52857017499997))",Xã Phú Dương,11305,5589,5716,475,508,1688
Phú Mậu,"POLYGON ((107.57866312018427 16.495604400335253, 107.5798089681254 16.495298854059172, 107.58152206388735 16.49530223614829, 107.58303570575697 16.49579887986198, 107.58473550114019 16.497140821989888, 107.58596929519024 16.498363506572957, 107.58704049498738 16.499385709908097, 107.58789783658136 16.50113125873804, 107.5885340552083 16.502296977754668, 107.59060668900014 16.505544663000023, 107.59315490800009 16.507606507000048, 107.59451293900008 16.509922028000062, 107.59216308600008 16.511327744000027, 107.59096527100019 16.514429092000114, 107.59214782800007 16.515958786000056, 107.59439086900011 16.516698837999968, 107.59442138700012 16.522171020000144, 107.59991455000016 16.521097184000098, 107.60303497300015 16.52459907600013, 107.60482025200014 16.523685456000067, 107.60499572800012 16.528341294000143, 107.60566711400008 16.528249742000014, 107.60520172000008 16.53152847300015, 107.604270934 16.533689499000104, 107.6020050050002 16.533565521000128, 107.59808349600019 16.534725190000074, 107.59749603400007 16.533599853000112, 107.59233856200001 16.534437180000054, 107.59188842800006 16.53363037200006, 107.5945968630001 16.53020668100004, 107.59374237100008 16.527748108000083, 107.59088134700016 16.526767730000188, 107.58868408100005 16.52453994800004, 107.58656310900011 16.52527618500011, 107.58253479000012 16.528284074000055, 107.58001709000018 16.52635765100007, 107.57754700830702 16.529753750638406, 107.57622745403887 16.527859052657675, 107.57560427371641 16.525776078256172, 107.57557457741217 16.523557783581964, 107.5762855669928 16.521322621276227, 107.57692413305858 16.519445990578276, 107.57788475439378 16.517279772535858, 107.57905600643062 16.515193395642882, 107.579588512123 16.51451459775444, 107.57993093388768 16.513358204355598, 107.57980387648576 16.512120777316227, 107.57942169819728 16.510754796447713, 107.57862491569205 16.50896797105429, 107.57800136415472 16.5071737325365, 107.57754942274971 16.504984819263655, 107.57741736326 16.502670536549545, 107.57727768779569 16.500801853861844, 107.57759005530818 16.498222712507356, 107.57824999204615 16.49615166093389, 107.57866312018427 16.495604400335253))",Xã Phú Mậu,10916,5416,5500,458,491,1630
Phú Thanh,"POLYGON ((107.57754700830702 16.529753750638406, 107.58001709000018 16.52635765100007, 107.58253479000012 16.528284074000055, 107.58656310900011 16.52527618500011, 107.58868408100005 16.52453994800004, 107.59088134700016 16.526767730000188, 107.59374237100008 16.527748108000083, 107.5945968630001 16.53020668100004, 107.59188842800006 16.53363037200006, 107.59233856200001 16.534437180000054, 107.59749603400007 16.533599853000112, 107.59808349600019 16.534725190000074, 107.6020050050002 16.533565521000128, 107.604270934 16.533689499000104, 107.60520172000008 16.53152847300015, 107.61573791600006 16.52926445000014, 107.61656189000018 16.530889511000055, 107.6200561510002 16.532083512000156, 107.62026977600004 16.533077241000058, 107.62668609700006 16.534379959000034, 107.62594604500009 16.53729438800019, 107.62318766011708 16.53987337611784, 107.62093725744842 16.540053642464045, 107.62115280552683 16.541568783309515, 107.62055756967248 16.542375769103103, 107.61967309465763 16.543247072598604, 107.6184893523556 16.543846906316958, 107.6153868202694 16.544206828641563, 107.61325524338872 16.54499886538872, 107.61036229379914 16.54507896969818, 107.608336262862 16.54698345296157, 107.60591643626157 16.54844406389776, 107.60341530386205 16.549090897250494, 107.60233587939456 16.54916735410876, 107.60033420405745 16.548613203226466, 107.59855439679518 16.548869413589046, 107.59692253846049 16.54862426632974, 107.59645535796284 16.547617842437262, 107.59436331921012 16.547537521079335, 107.59340297224514 16.54661091749972, 107.59219960376879 16.544597675092234, 107.59163555303252 16.542288880401372, 107.59088091984637 16.540265222662185, 107.58962733563413 16.53866327450868, 107.58803543359869 16.537260679915335, 107.58593579222429 16.535721754171163, 107.58344306739241 16.53462913717749, 107.58142203444004 16.533338612518264, 107.57973757464458 16.532109030698052, 107.57878300065494 16.531645987589513, 107.57754700830702 16.529753750638406))",Xã Phú Thanh,4162,2081,2081,175,187,622
Phú Thượng,"POLYGON ((107.59422466155746 16.48937926886117, 107.596321106 16.489124299000082, 107.59692382700007 16.486240386000134, 107.59943390000018 16.484556199000167, 107.60383605900017 16.483501435000107, 107.60581970200008 16.48392486500012, 107.60864257900016 16.48513984700014, 107.6089630140001 16.48738288900006, 107.60997772200005 16.488664627000105, 107.61492919900019 16.489324570000065, 107.6147766110002 16.492410660000132, 107.61585235600012 16.493844987000102, 107.61494445900001 16.495948791000046, 107.6154403700001 16.503093721000084, 107.61491394000006 16.50810813800007, 107.61033630300011 16.509235383000032, 107.60483550999999 16.508356095000067, 107.60478210500014 16.50946235700013, 107.60157775800013 16.508985519000134, 107.60174560600012 16.50633621300011, 107.59980774000002 16.50460624699997, 107.59867858900014 16.50239372300007, 107.59605407700002 16.50410652100004, 107.59315490800009 16.507606507000048, 107.59125093270939 16.505412510444273, 107.58960326272546 16.50307806530253, 107.58916113052993 16.501882154281134, 107.5891849136554 16.501020527174376, 107.58967275780168 16.500127408759624, 107.59057796101803 16.499679273609104, 107.59168400697399 16.498147181903164, 107.59246790392086 16.49665240266802, 107.59293479620032 16.495382701404594, 107.59323914190469 16.494300669151983, 107.59373503736379 16.4918616091731, 107.59422466155746 16.48937926886117))",Phường Phú Thượng,20178,9820,10358,847,908,3013
Thuận An,"POLYGON ((107.6316551435304 16.565151305327902, 107.63266536778326 16.565231626394677, 107.63367590375975 16.56578455135275, 107.63456007812601 16.565933467561536, 107.63471712138403 16.56676543916359, 107.63566051689793 16.56617850041954, 107.63618130149882 16.564716414587622, 107.63669625617342 16.563436121088273, 107.63670886700811 16.562318964595136, 107.6375923799124 16.56168892555621, 107.63807456472534 16.56149655419648, 107.63696416170654 16.560810563889106, 107.63602848649492 16.560540680596148, 107.63603214841834 16.560171683781505, 107.63694599857973 16.560168917075544, 107.63767211238917 16.560543180537707, 107.63890979617929 16.561658232233867, 107.63973678785993 16.561484132173803, 107.64186240637582 16.559705999528603, 107.64626156169851 16.55669620393394, 107.64835325205792 16.555557224009362, 107.64496035988412 16.552417596088674, 107.64159652545356 16.552359456303805, 107.6374071087543 16.55240156294161, 107.63737334345211 16.551724889817137, 107.63566244876631 16.551737886755234, 107.63536377769816 16.550620279822738, 107.6359570746107 16.550001769742437, 107.63639920909281 16.54885267197369, 107.63383720671527 16.547901746410503, 107.63234572394526 16.547049872161665, 107.63015099488405 16.54620302954038, 107.6283871890978 16.54529014249391, 107.62753726291345 16.544689706132658, 107.62716186382528 16.544182449915525, 107.62773760424949 16.543296674666635, 107.62878036219456 16.541990197332666, 107.62984264679761 16.540898267408977, 107.63151648037456 16.53973688138518, 107.63098824161801 16.539321612968877, 107.6303931600093 16.538884434521492, 107.62967622048643 16.539451675261034, 107.62907675149751 16.54002630415107, 107.6279459957093 16.54081353409987, 107.62655248896289 16.541457920602454, 107.62568193821261 16.54150265476568, 107.62479026209729 16.540500076794103, 107.624347252892 16.539731934195117, 107.62383485843799 16.53945696698736, 107.62318766011708 16.53987337611784, 107.62326285951013 16.5387475182215, 107.62405102965403 16.53777988961832, 107.6239843767417 16.53608592125255, 107.62434576014562 16.535539236869454, 107.62575614666093 16.535340679166552, 107.62663447490803 16.534973613059094, 107.62751590137407 16.53501612734027, 107.62856858922027 16.53476261423782, 107.62963500813078 16.53449306343373, 107.63037612394322 16.5342359943877, 107.63174710081802 16.53440275809453, 107.6329680151386 16.534974762726108, 107.63414275639042 16.53623483860781, 107.63480161728177 16.537820042908265, 107.63601201646429 16.53757844448802, 107.63757789241782 16.53725447977058, 107.6402450185443 16.53784640888466, 107.64115927936462 16.539741022494468, 107.64179206909512 16.54243923628411, 107.64350182836188 16.54292717971913, 107.64580555763911 16.543108077564966, 107.64699748225303 16.543702109873664, 107.64726444616161 16.54603997908424, 107.64686623874064 16.54864508133585, 107.64680528590549 16.551026628027955, 107.64969985760126 16.55483128038435, 107.65315193753037 16.552960616521773, 107.65671510200372 16.551535202947377, 107.65814615218426 16.551065171506423, 107.65911653243228 16.55221379466036, 107.66020598911251 16.554069564039196, 107.66147782758031 16.55625895297993, 107.65307617100007 16.56067466700017, 107.64207707504477 16.56625286744395, 107.63924989763387 16.56787637252239, 107.6374433378075 16.568907564672543, 107.63541182695428 16.569852501062655, 107.63423404541976 16.57087074266161, 107.63331962514246 16.57192095756119, 107.63226845707965 16.572521899415335, 107.63109561896857 16.572914181219858, 107.62999272628258 16.57189514452415, 107.62854322551823 16.571942164215557, 107.62708258032194 16.572705678658508, 107.62562105344767 16.573485728394246, 107.62530207010604 16.572118963064213, 107.62546313266455 16.570881282579876, 107.62568083216212 16.569820001469964, 107.62604136651697 16.56914226878149, 107.62670581003408 16.568640710854368, 107.62723902343674 16.567652090648266, 107.62793414721608 16.56638288307613, 107.62932674398576 16.565692313947352, 107.63059266970095 16.565421933253504, 107.6316551435304 16.565151305327902))",Phường Thuận An,21495,10558,10937,902,967,3210
Gia Hội,"POLYGON ((107.5916330911844 16.474630421018546, 107.59139251800009 16.481918336000092, 107.59080602722264 16.482043882943955, 107.59109209162938 16.484996059118764, 107.59181114526362 16.488433838999974, 107.58263397200017 16.48965072600003, 107.58019256600014 16.491294861000085, 107.5813140860002 16.489250184000106, 107.5788879390001 16.487453460000125, 107.5820159910001 16.483221054000055, 107.58517456100014 16.47905922000014, 107.58963775600003 16.473533631000095, 107.590632005678 16.47280922813085, 107.5916330911844 16.474630421018546))",Phường Gia Hội,20004,9751,10253,840,900,2987
Thuận Lộc,"POLYGON ((107.5784858705689 16.49452814166216, 107.5783340032861 16.4945842255064, 107.57825933750763 16.494330058554908, 107.57767768259248 16.494314922817807, 107.57761099314155 16.494581275595124, 107.56765747100008 16.487010957000223, 107.56542067946214 16.48542316103243, 107.56610076458281 16.484572096732336, 107.5671509507834 16.483257884794682, 107.57034301700008 16.479263306000348, 107.57212066700009 16.48055076700001, 107.57353973400018 16.478689195000186, 107.57457733200005 16.47914314300027, 107.57543182300014 16.478055955000002, 107.57699585100005 16.479179383000087, 107.58017730699999 16.474998474000074, 107.58414459300019 16.47783279500021, 107.58129119900013 16.482431412000096, 107.5820159910001 16.48322105400007, 107.57888793900008 16.487453460000324, 107.58131408600019 16.489250184000127, 107.58019256600011 16.491294861000085, 107.57838439900019 16.49407005300003, 107.5784858705689 16.49452814166216))",Phường Thuận Lộc,21208,10357,10851,416,832,4820
Đông Ba,"POLYGON ((107.58517456100019 16.479059220000163, 107.58201599100015 16.48322105400008, 107.58129119900013 16.482431412000114, 107.58414459300023 16.47783279500003, 107.58017730699999 16.474998474000085, 107.57699585100009 16.47917938300007, 107.57543182300017 16.47805595500002, 107.57457733200009 16.47914314300009, 107.5735397340002 16.47868919500019, 107.57212066700012 16.48055076700003, 107.57034301700013 16.479263306000174, 107.57320404100015 16.474714279000107, 107.57361602800005 16.474987031000115, 107.57575225800005 16.472255707999988, 107.57299804600015 16.470085144000162, 107.57646179100013 16.46561431900017, 107.58051300100013 16.468540192000052, 107.58161163200009 16.467353821000035, 107.58333822074087 16.465572022481172, 107.58640656505354 16.467658776125187, 107.58819431689504 16.469611822197077, 107.59016740684903 16.47190584151949, 107.58963775599999 16.47353363100012, 107.58517456100019 16.479059220000163))",Phường Đông Ba,17224,8474,8750,703,1055,2376
